111111111111
100010000001
001010111101
111010000101
100001110100
111101010101
100101010101
110101010101
100000000101
111111011101
100000010001
111111111111
